NO eerercerv
SO erververv 
WE verv
EA rrev
F 500, 700, 800
C 500, 700, 800

111111111111111
111111111111111