NO eerercerv
SO erververv
WE verv
EA rrev
F 250, 175, 0
C 51, 4, 43

1111111
11111W111
1111111